####################
###   #   # ! #   ##
#   #   #  !#!  # A#
#  ## #   # ! # ####
##  # ##############
#  ##  #          ##
##  ## #        #! #
# !## !#   1    ## #
##! # ##    2   #! #
# !## !#        # ##
##  ##          #  #
#  ############### #
##  ##   # ! #   # #
# !##B #  !#!  #   #
##! ##   # ! #   # #
# !############### #
##!## # # # # # #  #
#  !!!!   !!!      #
#  # # # # # # # ###
####################
