####################
###   #   # ! #   ##
#   #   #  !#!  # A#
#  ## #   # ! # ####
##  # ##############
#  ##  #          ##
##  ## #        #! #
# !## !#   14   ## #
##! # ##   32   #! #
# !## !#        # ##
##  ##          #  #
#D ############### #
##  ##   # ! #   # #
# !##B #  !#!  #   #
##! ##   # ! #   # #
# !############### #
##!## # # # # # #  #
#  !!!!   !!!      #
#  # # #C# # # # ###
####################
