####################
###   #   # ! #   ##
#   #   #  !#!  # A#
#  ## #   # ! # ####
##  # ##############
#  ##  #          ##
##  ## #        #! #
# !## !#   1    ## #
##! # ##   32   #! #
# !## !#        # ##
##  ##          #  #
#  ############### #
##  ##   # ! #   # #
# !##B #  !#!  #   #
##! ##   # ! #   # #
# !############### #
##!## # # # # # #  #
#  !!!!   !!!      #
#  # # #C# # # # ###
####################
